GSGSSWSGWG
SWGSGSGSSW
GGSSWGSS#G
SGSGGSWSSG
GGWGSSSSWS
SGSWSGS#GS
WSSSGSGS#S
S#GGGWGWGW
SSSWGSSGG#
SS#SGWWWWS
S#W#GGG#WG
WW#GSSSIGG
SG#SW##SSW
SSSSS#GS#T
WWSGGGGS#G
WGGSG#SGSW
SGGGGGSGS#
GSSWGSWWSS
G#STGSWGSF
GGSSWWWGSW