GGWGSGW##SWGSSSWSWGW
SWGWSS#GSWWSTWGGGS##
#SISSSGGGGSGGGSSSSWS
GSWGSSWS###SGSGSSWSS
#GGGGSSGGGGS#GGGWS##
SWSWGGGSWWWSSGWG#G##
SGGS#SGW#GGSGWWFGGGS
SGGWWSSWS#WWGSGSGSGG
#GSSSWGG##WGSGGSGSGG
WWWWGG#GSGSGSWTWSGGG
GWSGSSWSSGGGGSGGGWGG
GGGGGGGWSWSSWWSGWSGS
GGWG#WWG#G#SGGSWSSGS
SS#G#GS##SWGSGGG#WGW
SWS##SSWSSGGGGSWSSGS
SWSGSGGGGWGGGGSWGSWG
SWGGSGSSGW#SGGSGWGSG
W#SG##GS#SSGWSWSWGSW
GWWG#SGSGSGSSSWW#S#G
WSWW#SSS#GSGSGGSGSWG