TF*#SSSSGGW#WSW#G#GG
GG*WSSWSGGWS#GGWG#SS
SS*IGWTGSSSGSWGGSW#G
S#WGGSGGSSWG#GGWWSWW
GSGWGGSSSGSGWGSWSSG#
SWS#GWW#SSSS#W##WSSG
SWGGS#WGGGWSSSGGWWWS
SSSW#GS#GG#SGGWS#SSW
SGGSWGG#GWWSGSSGS#SG
SSGW#SSWWGGW#S##SW#W
