GGGGWS#WSW
GSGGWSW#SW
GWSSSSWGGG
#G#WWSSSWW
S#GG#SGSTG
SSSW#G#W#S
#WSW**ISGW
GWSGF#SGGG
STSSWG#GSS
G#WGSGW#GS
